0000000111,
0110111110,
0110111110,
0110111110,
0110101110,
0111101110,
0111101110,
0000000000
